São criadas, na 1ª Região da Justiça do Trabalho, dezenove Juntas de Conciliação e Julgamento, no Estado do Rio de Janeiro, assim distribuídas: dez na cidade do Rio de Janeiro (26ª a 35ª ) e uma nas cidades de Araruama, Barra do Piraí, Duque de Caxias (3ª), Niterói (3ª), Nova Iguaçu (3ª), Petrópolis (2ª), São João do Meriti, Volta Redonda (2ª) e Teresópolis. 
Ficam assim definidas as áreas de Jurisdição das Juntas de Conciliação e Julgamento, localizadas nas cidades abaixo, pertencentes à 1ª Região da Justiça do Trabalho: 
no Estado do Rio de Janeiro: 
Rio de Janeiro: o respectivo Município; 
Araruama: o respectivo Município e os de Cabo Frio, Casimiro de Abreu, São Pedro da Aldeia e Saquarema; 
Barra do Piraí: o respectivo Município e os de Mendes, Miguel Pereira, Paulo de Frontin, Piraí, Valença e Vassouras; 
Campos: o respectivo Município e os de Conceição de Macabu, Macaé, São Fidélis e São João da Barra; 
Duque de Caxias: o respectivo Município e o de Magé; 
Itaperuna: o respectivo Município e os de Bom Jesus de Itabapoana, Cambuci, Itaocara, lage do Muriaé, Miracema, Natividade, Porciúncula e Santo Antônio de Pádua; 
Niterói: o respectivo Município e o de Maricá; 
Nova Friburgo: o respectivo Município e os de Bom Jardim, Cachoeiro de Macacu, Cantagalo, Carmo, Cordeiro, Duas Barras e Sumidouro; 
Nova Iguaçu: o respectivo Município e os de Itaguaí e Paracambi; 
Petrópolis: o respectivo Município; 
São Gonçalo: o respectivo Município e os de Itaboraí e Rio Bonito; 
São João do Meriti: o respectivo Município e o de Nilópolis; 
Teresópolis: o respectivo Município; 
Três Rios: o respectivo Município e os de Paraíba do Sul, Rio das Flores e Sapucaia; 
Volta Redonda: o respectivo Município e os de Barra Mansa e Resende. 
no Estado do Espírito Santo: 
Vitória: o respectivo Município e os de Cariacica, Guarapari, Serra, Viana e Vila Velha; 
Cachoeiro do Itapemirim: o respectivo Município e os de Alegre, Alfredo Chaves, Anchieta, Apiacá, Atílio Vivacqua, Bom Jesus do Norte, Castelo, Guaçuí, Iconha, Iúna, Itapemirim, Jerônimo Monteiro, Mimoso do Sul, Muniz Freire, Muqui, Piúma, Presidente Kennedy, Rio Novo do Sul e São José do Calçado; 
Colatina: o respectivo Município e os de Baixo Guandu, Fundão, Ibiraçu, Itaquaçu, Itarana, Linhares, Pancas, Santa Teresa e São Gabriel da Palha. 
São criadas, na 2ª Região da Justiça do Trabalho, quarenta e uma Juntas de Conciliação e Julgamento, sendo quarenta no Estado de São Paulo, assim distribuídas: treze na cidade de São Paulo (33ª a 45ª), duas nas cidades de São Bernardo do Campo (2ª e 3ª) e Cubatão e uma nas cidades de Araçatuba, Avaré, Barueri, Botucatu, Campinas (2ª), Catanduva, Diadema, Franco da Rocha, Guaratinquetá, Guarulhos (2ª), Itapecerica da Serra, Itu, Jaboticabal, Jacareí, Jaú, Jundiaí (2ª), Marília, Mogi-Mirim, Ourinhos, Presidente Prudente, São João da Boa Vista, São José do Rio Pardo e Votuporanga; e uma no Estado de Mato Grosso do Sul, na cidade de Campo Grande. 
Ficam assim definidas as áreas de jurisdição das Juntas de Conciliação e Julgamento, localizadas nas cidades abaixo, pertencentes à 2ª Região da Justiça do Trabalho: 
no Estado de São Paulo: 
São Paulo: o respectivo Município; 
Americana: o respectivo Município e os de Cosmópolis, Nova Odessa, Santa Bárbara D'Oeste e Sumaré; 
Araçatuba: o respectivo Município e os de Bento de Abreu, Bilac, Birigui, Buritama, Coroados, Gabriel Monteiro, Glicério, Guararapes, Nova Lusitânia, Penápolis, Rubiácea, Turiúba e Valparaíso; 
Araraquara: o respectivo Município e os de Américo Brasiliense, Boa Esperança do Sul, Matão, Nova Europa, Rincão e Santa Lúcia; 
Avaré: o respectivo Município e os de Arandu, Cerqueira César, Itaí, Itatinga, Manduri, Óleo, Paranapanema, Piraju, Santa Bárbara do Rio Pardo e Tejupá; 
Barretos: o respectivo Município e os de Colina, Colômbia, Guaíra, Guaraci, lpuã, Jaborandi, Olímpia e Severínia; 
Barueri: o respectivo Município e os de Carapicuíba, Itapevi, Jandira, Pirapora do Bom Jesus e Santana de Parnaíba; 
Bauru: o respectivo Município e os de Agudos, Arealva, Avaí e Piratininga; 
Botucatu: o respectivo Município e os de Anhembi, Areiópolis, Bofete, Conchas, Guareí, Lençóis Paulista, Pardinho, Pereiras, Porangaba, Santa Maria da Serra e São Manuel; 
Campinas: o respectivo Município e os de Paulínia e Valinhos; 
Catanduva: o respectivo Município e os de Ariranha, Cajobi, Catiguá, Ibirá, Irapuã, Itajobi , Monte Azul Paulista, Novo Horizonte, Palmares Paulista, Paraíso, Pindorama, Piranji, Sales, Santa Adélia, Tabapuã e Urupês; 
Cubatão: o respectivo Município; 
Diadema: o respectivo Município; 
Franca: o respectivo Município e os de Batatais, Cristais Paulista, Itirapuã, Jeriquara, Patrocínio Paulista, Restinga, Ribeirão Corrente e São José da Bela Vista; 
Franco da Rocha: o respectivo Município e os de Caieiras, Cajamar, Francisco Morato e Mairiporã; 
Guaratinquetá: o respectivo Município e os de Aparecida, Areias, Cachoeira Paulista, Cruzeiro, Cunha, Lagoinha, Lavrinhas, Lorena, Piquete, Queluz, Roseira, São Bento do Sapucaí e Silveiras; 
Guarulhos: o respectivo Município e o de Arujá; 
Itapecerica da Serra: o respectivo Município e os de Embu, Embu-Guaçu, Juquitiba e Taboão da Serra; 
Itu: o respectivo Município e os de Boituva, Cabreúva, Capivari, Elias Fausto, Indaiatuba, Porto Feliz, Rafard e Salto; 
Jaboticabal: o respectivo Município e os de Barrinha, Bebedouro, Cândido Rodriques, Dobrada, Fernando Prestes, Guariba, Monte Alto, Pitangueiras, Pontal, Pradópolis, Santa Ernestina, Sertãozinho, Taiaçu, Taiúva, Taquaritinga e Vista Alegre do Alto; 
Jacareí: o respectivo Município e os de Igaratá, Santa Branca e Santa Isabel; 
Jaú: o respectivo Município e os de Bariri, Barra Bonita, Bocaina, Boracéia, Dois Córregos, Igaraçu do Tietê, Itapuí, Macatuba, Mineiros do Tietê e Pederneiras; 
Jundiaí: o respectivo Município e os de Campo limpo Paulista, Itatiba, Itupeva, Jarinu, Louveira, Morungaba, Várzea Paulista e Vinhedo; 
Limeira: o respectivo Município e os de Cordeirópolis e Iracemápolis; 
Marília: o respectivo Município e os de Álvaro de Carvalho, Echaporã, Cuaimbê, Garça, Getulina, Júlio Mesquita, Lupércio, Lutécia, Ocauçu, Oriente, Oscar Bressane, Pompéia, Quintana e Vera Cruz; 
Mauá: o respectivo Município e os de Rio Grande da Serra e Ribeirão Pires; 
Mogi das Cruzes: o respectivo Município e os de Biritiba-Mirim, Guararema e Salesópolis; 
Mogi-Mirim: o respectivo Município e os de Águas de Lindóia, Amparo, Artur Nogueira, Conchal, Itapira, Jaquariúna, Lindóia, Mogi-Guaçu, Pedreira, Santo Antônio de Posse, Serra Negra e Socorro; 
Osasco: o respectivo Município; 
Ourinhos: o respectivo Município e os de Bernardino de Campos, Campos Novos Paulista, Chavantes, Ibirarema, lpauçu, Palmital, Ribeirão do Sul, Salto Grande, Santa Cruz do Rio Pardo, São Pedro do Turvo, Sarutaiá e Timburi; 
Piracicaba: o respectivo Município e os de Águas de São Pedro, Charqueada, Rio das Pedras e São Pedro; 
Presidente Prudente: o respectivo município e os de Alfredo Marcondes, Alvares Machado, Anhumas, Caiabu, FIora Rica, lepê, Indiana, Mariápolis, Martinópolis, Narandiba, Piquerobi, Piquete, Pirapozinho, Presidente Bernardes, Presidente Epitácio, Presidente Venceslau, Rancharia, Regente Feijó, Santo Anastácio, Santo Expedito, Taciba e Tarabaí; 
Ribeirão Preto: o respectivo Município e os de Cravinhos, Dumont, Jardinópolis, São Simão e Serrana; 
Rio Claro: o respectivo Município e os de Corumbataí, Ipeúna, Itirapina, Leme e Santa Gertrudes; 
Santo André: respectivo Município; 
Santos: o respectivo Município e os de Bertioga, Guarujá, Praia Grande (até Solemar), São Vicente e Vicente de Carvalho; 
São Bernardo do Campo: o respectivo Município; 
São Caetano do Sul: o respectivo Município; 
São Carlos: o respectivo Município e os de Analândia, Brotas, Descalvado e Ibaté; 
São João da Boa Vista: o respectivo Município e os de Aguaí, Aguas da Prata, Pinhal e Santo Antônio do Jardim; 
São José do Rio Pardo: o respectivo Município e os de Caconde, Casa Branca, Divinolândia, Itobi, Mococa, São Sebastião da Grama, Tambaú, Tapiratiba e Vargem Grande do Sul; 
São José do Rio Preto: o respectivo Município e os de Bady Bassitt, Bálsamo, Cedral , Guapiaçu, Icém, Jaci, José Bonifácio, Mirassol, Mirassolândia, Monte Aprazível, Neves Paulista, Nipoã, Nova Granada, Onda Verde, Palestina, Poloni, Pontes Gestal , Potirendaba, Tanabi, Uchoa e União Paulista; 
São José dos Campos: o respectivo município e os de Caçapava , Campos do Jordão, Jambeiro, Monteiro Lobato, Natividade da Serra, Paraibuna e Santo Antônio do Pinhal; 
Sorocaba: o respectivo Município e os de Araçoiaba da Serra, Capela do Alto, lperó, Mairinque, Salto de Pirapora e Votorantim; 
Suzano: o respectivo Município e os de Ferraz de Vasconcelos, Itaquaquecetuba e Poá; 
Taubaté: o respectivo Município e os de Pindamonhangaba, Redenção da Serra, São Luís do Paraitinga e Tremembé; 
Votuporanga: o respectivo Município e os de Álvaro Florence, Américo de Campos, Cosmorama, Floreal, Magda, Meridiano, Nhandeara, Pedranópolis, Sebastianópolis do Sul e Valentim Gentil; 
no Estado de Mato Grosso: 
Cuiabá: o respectivo Município e os de Acorizal, Aripuanã, Barão de Melgaço, Chapada dos Guimarães, Diamantino, Nossa Senhora do Livramento, Rosário do Oeste, Santo Antônio de Leverger e Várzea Grande; 
Corumbá: o respectivo Município e os de Ladário e Porto Esperança; 
no Estado de Mato Grosso do Sul:  Campo Grande: o respectivo Município e os de Aquidauana, Corguinho, Bandeirantes, Jaraguari, Ribas do Rio Pardo, Rochedo, Sidrolândia e Terenos. 
São criadas, na 3ª Região da Justiça do Trabalho, dezessete Juntas de Conciliação e Julgamento, sendo treze no Estado de Minas Gerais, assim distribuídas: uma nas cidades de Betim, Contagem, Coronel Fabriciano, Divinópolis, Itajubá, João Monlevade, Ouro Preto, Passos, Poços de Caldas, Ponte Nova, Pouso Alegre, Sete Lagoas e Varginha; três no Distrito Federal, em Brasília (6ª a 8ª); e uma no estado de Goiás, na cidade de Goiânia. 
Ficam assim definidas as áreas de jurisdição das Juntas de Conciliação e Julgamento, localizadas nas cidades abaixo, pertencentes à 3ª Região da Justiça do Trabalho: 
no Estado de Minas Gerais: 
Belo Horizonte: o respectivo Município e os de Baldim, Caeté, Jaboticatubas, José de Melo, Lagoa Santa, Nova Lima, Raposos, Rio Acima, Sabará, Santa luzia, Santana do Riacho, Taquaraçu de Minas e Vespasiano;  Il - Barbacena: o respectivo Município e os de Alto Rio Doce, Antônio Carlos, Aracitaba, Barroso, Bias Fortes, Brás Pires, CapeIa Nova, Carandaí, Cipotânea , Desterro do Melo, Dores do Turvo, Ewbank da Câmara, Ibertioga, Mercês, Oliveira Fortes, Paiva, Ressaquinha, Rio Pomba, Santa Bárbara do Tugúrio, Santa Rita do Ibitipoca, Santos Dumont, Senador Firmino, Senhora dos Remédios, Silveirânia e Tabuleiro; 
Betim: o respectivo Município e os de Bonfim, Brumadinho, Crucilândia, Ibirité, Igarapé, Mateus Leme, Piedade dos Gerais e Rio Manso; 
Cataguases: o respectivo Município e os de Além Paraíba, Argirita, Astolfo Dutra, Barão de Monte Alto, Divinésia, Dona Euzébia, Estrela Dalva, Guarani, Guidoval, Guiricema, Itamarati de Minas, Laranjal, Leopoldina, Miradouro, Muriaí, Murioé, Palma, Patrocínio do Muriaé, Paula Cândido, Pirapetinga, Piraúba, Recreio, Rodeiro, Santana de Cataguases, Santo Antônio do Aventureiro, São Geraldo, Tocantins, Ubá, Vieiras, Visconde do Rio Branco e Volta Grande; 
Conselheiro Lafaiete: o respectivo Município e os de Belo Vale, Caranaíba, Casa Grande, Catas Altas da Noruega, Congonhas, Cristiano Otoni, Desterro de Entre Rios, Entre Rios de Minas, Itaverava, Jeceaba, Lamim, Moeda, Ouro Branco, Piranga, Porto Firme, Presidente Bernardes, Queluzita, Rio Espera, Santana dos Montes, São Brás do Suaçuí e Senhora de Oliveira; 
Contagem: o respectivo Município e o de Esmeraldas; 
Coronel Fabriciano: o respectivo Município e os de Antônio Dias, Belo Oriente, Joanésia, Ipatinga, Mesquita e Timóteo; 
Divinópolis: o respectivo Município e os de Camacho, Carmo do Cajuru, Cláudio, Itaquara, Itapecerica, Itatiaiuçu, Itaúna, Pedra do Indaiá e São Sebastião do Oeste; 
Governador Valadares: o respectivo Município e os de Alpercata, Divino das Laranjeiras, Galiléia e Vila Matias; 
Itajubá: o respectivo Município e os de Brazópolis, Conceição da Pedra, Conceição dos Ouros, Consolação, Delfim Moreira, Gonçalves, Marmelópolis, Natércia, Paraisópolis, Pedralva, Piranguçu, Piranguinho, São José do Alegre, Sapucaí-Mirim e Wenceslau Braz; 
João Monlevade: o respectivo Município e os de Alvinópolis, Barão de Cocais, Bela Vista de Minas, Bom Jesus do Amparo, Dionísio, Dom Silvério, Itabira, Itambé do Mato Dentro, Jaguaraçu, Marliéria, Nova Era, Passabém, Rio Piracicaba, Santa Bárbara, Santa Maria do Itabira , São Domingos do Prata, São Gonçalo do Rio Abaixo e São José do Goiabal; 
Juiz de Fora: o respectivo Município e os de Belmiro Braga, Bicas, Chácara, Chiador, Coronel Pacheco, Descoberto, Guarará, Lima Duarte, Mar de Espanha, Maripá de Minas, Matias Barbosa, Olaria, Pedro Teixeira, Pequeri, Piau, Rio Novo, Rochedo de Minas, Santana do Deserto, Santana do Garambéu, Senador Cortes, Simão Pereira e São João Nepomuceno; 
Montes Claros: o respectivo Município e os de Bocaiúva, Botumirim, Brasília de Minas, Capitão Enéas, Claro dos Poções, Coração de Jesus, Cristália, Engenheiro Navarro, Francisco Dumont, Francisco Sá, Grão Mogol, Ibiaí, Itacambira, Juramento, Lagoa dos Patos, Mirabela e Ubaí; 
Ouro Preto: o respectivo Município e os de Acaiaca, Diogo de Vasconcelos, Itabirito e Mariana; 
Passos: o respectivo Município e os de AIpinópolis, Capetinga, Cássia, Claraval, Delfinópolis, Fortaleza de Minas, Ibiraci, Jacuí, Pratápolis, São João Batista do Glória, São Sebastião do Paraíso e São Tomás de Aquino; 
Poços de Caldas: o respectivo Município e os de Andradas, Bandeira do Sul, Botelhos, Cabo Verde, Caldas, Campestre, Carvalhópolis, Divisa Nova, Ibitiúra de Minas, Ipuiúna, Machado, Poço Fundo e Santa Rita de Caldas; 
Ponte Nova: o respectivo Município e os de Abre Campos, Amparo da Serra, Barra Longa, Cajuri, Canaã, Caputira, Coimbra, Guaraciaba, Jequeri, Matipó, Pedra do Anta, Piedade de Ponte Nova, Raul Soares, Rio Casca, Rio Doce, Santa Cruz do Escalvado, Santa Margarida, Santo Antônio do Grama, São Miguel do Anta, São Pedro dos Ferros, Sericita, Teixeiras, Urucânia e Viçosa; 
Pouso Alegre: o respectivo Município e os de Albertina, Borda da Mata, Cachoeira de Minas, Cambuí, Congonhal, Bom Repouso, Bueno Brandão, Camanducaia, Córrego do Bom Jesus, Espírito Santo do Dourado, Estiva, Extrema, Inconfidentes, Itapeva, Jacutinga, Munhoz, Monte Sião, Ouro Fino, São João da Mata, São Sebastião da Bela Vista, Santa Rita do Sapucaí, Senador José Bento, Silvianópolis e Toledo; 
São João Del Rey: o respectivo Município e os de Cassiterita, Coronel Xavier Chaves, Dores de Campos, Lagoa Dourada, Nazareno, Prados, Resende Costa, Ritápolis e Tiradentes; 
Sete Lagoas: o respectivo Município e os de Araçaí, Cachoeira de Macacos, Caetanópolis, Copim Branco, Cordisburgo, Fortuna de Minas, Funilândia, Inhaúma, Jequitibá, Matozinhos, Paraopeba, Pedro Leopoldo, Prudente de Morais, Ribeirão das Neves e Santana de Pirapama; 
Uberaba: o respectivo Município e os de Águas Compridas, Campo Florido, Conceição das Alagoas, Conquista, Pirajuba, Sacramento e Veríssimo; 
Uberlândia: o respectivo Município e os de Araguari, Cascalho Rico, Estrela do Sul, Grupiara, Indianópolis, Monte Alegre de Minas, Nova Ponte e Tupaciguara; 
Varginha: o respectivo Município e os de Boa Esperança, Cambuquira, Campanha, Careaçu, Carmo da Cachoeira, Conceição do Rio Verde, Coqueiral, Cordislândia, Elói Mendes, Fama, Heliodora, Ilicínea, Jesuânia, Lambari, Monsenhor Paulo Nepomuceno, Paraguaçu, Santana da Vargem, São Bento Abade, São Gonçalo do Sapucaí, Três Corações, Três Pontas e Turvolândia; 
no Distrito Federal: 
