São criadas na Justiça do Trabalho da 15ª Região as seguintes Juntas de Conciliação e Julgamento e cargos pertinentes, assim distribuídos: 
na cidade de Campinas, uma Junta de Conciliação e Julgamento (9ª), um cargo de Juiz do Trabalho Presidente de Junta, um cargo de Juiz do Trabalho Substituto, dois cargos de Juiz Classista de Junta, observada a representação paritária, e uma Função Comissionada de Diretor de Secretaria de Junta - FC-09; 
na cidade de Ribeirão Preto, uma Junta de Conciliação e Julgamento (5ª), um cargo de Juiz do Trabalho Presidente de Junta, um cargo de Juiz do Trabalho Substituto, dois cargos de Juiz Classista de Junta, observada a representação paritária, e uma Função Comissionada de Diretor de Secretaria de Junta - FC-09; 
na cidade de Caçapava, uma Junta de Conciliação e Julgamento (1ª), um cargo de Juiz do Trabalho Presidente de Junta, um cargo de Juiz do Trabalho Substituto, dois cargos de Juiz Classista de Junta, observada a representação paritária, e uma Função Comissionada de Diretor de Secretaria de Junta - FC-09; 
na cidade de Capão Bonito, uma Junta de Conciliação e Julgamento (1ª), um cargo de Juiz do Trabalho Presidente de Junta, um cargo de Juiz do Trabalho Substituto, dois cargos de Juiz Classista de Junta, observada a representação paritária, e uma Função Comissionada de Diretor de Secretaria de Junta - FC-09; 
na cidade de Itapira, uma Junta de Conciliação e Julgamento (1ª), um cargo de Juiz do Trabalho Presidente de Junta, um cargo de Juiz do Trabalho Substituto, dois cargos de Juiz Classista de Junta, observada a representação paritária, e uma Função Comissionada de Diretor de Secretaria de Junta - FC-09; 
na cidade de Jaboticabal, uma Junta de Conciliação e Julgamento (2ª), um cargo de Juiz do Trabalho Presidente de Junta, um cargo de Juiz do Trabalho Substituto, dois cargos de Juiz Classista de Junta, observada a representação paritária, uma Função Comissionada de Diretor de Secretaria de Junta - FC-09 e uma Função Comissionada de Diretor de Serviço de Distribuição dos Feitos - FC-08; 
na cidade de Paulínea, uma Junta de Conciliação e Julgamento (2ª), um cargo de Juiz do Trabalho Presidente de Junta, um cargo de Juiz do Trabalho Substituto, dois cargos de Juiz Classista de Junta, observada a representação paritária, uma Função Comissionada de Diretor de Secretaria de Junta - FC-09 e uma Função Comissionada de Diretor de Serviço de Distribuição dos Feitos - FC-08; 
na cidade de Penápolis, uma Junta de Conciliação e Julgamento (1ª), um cargo de Juiz do Trabalho Presidente de Junta, um cargo de Juiz do Trabalho Substituto, dois cargos de Juiz Classista de Junta, observada a representação paritária, e uma Função Comissionada de Diretor de Secretaria de Junta - FC-09; 
na cidade de Presidente Prudente, uma Junta de Conciliação e Julgamento (2ª), um cargo de Juiz do Trabalho Presidente de Junta, um cargo de Juiz do Trabalho Substituto, dois cargos de Juiz Classista de Junta, observada a representação paritária, uma Função Comissionada de Diretor de Secretaria de Junta - FC-09 e uma Função Comissionada de Diretor de Serviço de Distribuição dos Feitos - FC-08; 
na cidade de São Joaquim da Barra, uma Junta de Conciliação e Julgamento (1ª), um cargo de Juiz do Trabalho Presidente de Junta, um cargo de Juiz do Trabalho Substituto, dois cargos de Juiz Classista de Junta, observada a representação paritária, e uma Função Comissionada de Diretor de Secretaria de Junta - FC-09; 
na cidade de São Sebastião, uma Junta de Conciliação e Julgamento (1ª), um cargo de Juiz do Trabalho Presidente de Junta, um cargo de Juiz do Trabalho Substituto, dois cargos de Juiz Classista de Junta, observada a representação paritária, e uma Função Comissionada de Diretor de Secretaria de Junta - FC-09; 
na cidade de Sertãozinho, uma Junta de Conciliação e Julgamento (2ª), um cargo de Juiz do Trabalho Presidente de Junta, um cargo de Juiz do Trabalho Substituto, dois cargos de Juiz Classista de Junta, observada a representação paritária, uma Função Comissionada de Diretor de Secretaria de Junta - FC-09 e uma Função Comissionada de Diretor de Serviço de Distribuição dos Feitos - FC-08; 
na cidade de Sumaré, uma Junta de Conciliação e Julgamento (1ª), um cargo de Juiz do Trabalho Presidente de Junta, um cargo de Juiz do Trabalho Substituto, dois cargos de Juiz Classista de Junta, observada a representação paritária, e uma Função Comissionada de Diretor de Secretaria de Junta - FC-09; 
na cidade de Tatuí, uma Junta de Conciliação e Julgamento (1ª), um cargo de Juiz do Trabalho Presidente de Junta, um cargo de Juiz do Trabalho Substituto, dois cargos de Juiz Classista de Junta, observada a representação paritária, e uma Função Comissionada de Diretor de Secretaria de Junta - FC-09; 
na cidade de Teodoro Sampaio, uma Junta de Conciliação e Julgamento (1ª), um cargo de Juiz do Trabalho Presidente de Junta, um cargo de Juiz do Trabalho Substituto, dois cargos de Juiz Classista de Junta, observada a representação paritária, e uma Função Comissionada de Diretor de Secretaria de Junta - FC-09. 
Para cada Juiz Classista de Junta haverá um Suplente. 
São assim definidas as áreas de jurisdição das Juntas de Conciliação e Julgamento, localizadas nas seguintes cidades, pertencentes à 15ª Região, no Estado de São Paulo, com sede na cidade de Campinas: 
Campinas: o respectivo Município e os de Jaguariúna e Valinhos; 
Adamantina: o respectivo Município e os de Flora Rica, Flórida Paulista, Inúbia Paulista, Lucélia, Mariápolis, Osvaldo Cruz, Pacaembu, Pracinha, Sagres e Salmourão; 
Americana: o respectivo Município e o de Nova Odessa; 
Amparo: o respectivo Município e os de Monte Alegre do Sul, Morungaba, Pedreira e Serra Negra; 
Andradina: o respectivo Município e os de Castilho, Guaraçaí, Ilha Solteira, Itapura, Lavínia, Mirandópolis, Murutinga do Sul, Nova Independência, Pereira Barreto e Sud Menucci; 
Araçatuba: o respectivo Município e os de Bento de Abreu, Guararapes, Rubiácea, Santo Antônio do Aracanguá e Valparaíso; 
Araraquara: o respectivo Município e os de Américo Brasiliense, Boa Esperança do Sul, Gavião Peixoto, Motuca, Rincão, Santa Lúcia e Trabiju; 
Araras: o respectivo Município e os de Conchal, Leme e Santa Cruz da Conceição; 
Assis: o respectivo Município e os de Cruzália, Cândido Mota, Echaporã, Florínea, Maracaí, Palmital, Paraguaçu Paulista, Pedrinhas Paulista, Platina e Tarumã; 
Avaré: o respectivo Município e os de Águas de Santa Bárbara, Arandu, Cerqueira César, Iaras, Itaí, Manduri, Paranapanema e Óleo; 
Barretos: o respectivo Município e os de Colina, Colômbia, Guaíra e Jaborandi; 
Batatais:o respectivo Município e os de Altinópolis, Brodósqui, Jardinópolis, Nuporanga, Orlândia, Sales de Oliveira e Santo Antônio da Alegria; 
Bauru: o respectivo Município e os de Agudos, Arealva, Avaí, Cabrália Paulista, Duartina, lacanga, Lucianópolis, Paulistânia, Piratininga, Presidente Alves e Ubirajara; 
Bebedouro: o respectivo Município e os de Ibitiúva, Monte Azul Paulista, Pirangi, Pitangueiras, Taquaral, Terra Roxa e Viradouro; 
Birigüi: o respectivo Município e os de Bilac, Brejo Alegre, Buritama, Clementina, Coroados, Gabriel Monteiro, Lourdes, Piacatu, Santópolis do Aguapeí e Turiúba; 
Botucatu: o respectivo Município e os de Anhembi, Bofete, Itatinga, Pardinho, Pratânia e São Manuel; 
Bragança Paulista: o respectivo Município e os de Atibaia, Bom Jesus dos Perdões, Joanópolis, Nazaré Paulista, Pedra Bela, Pinhalzinho, Piracaia, Tuiuti e Vargem; 
Caçapava: o respectivo Município e o de Jambeiro; 
Cajuru: o respectivo Município e os de Cássia dos Coqueiros, Santa Cruz da Esperança, Santa Rosa do Viterbo e Serra Azul; 
Campo Limpo Paulista: o respectivo Município e os de Jarinu e Várzea Paulista; 
Capão Bonito: o respectivo Município e os de Apiaí, Barra do Chapéu, Guapiara, Iporanga, Itapirapuã Paulista, Itaóca, Ribeira e Ribeirão Grande; 
Capivari: o respectivo Município e os de Elias Fausto, Mombuca, Monte Mor, Rafard e Rio das Pedras; 
Caraguatatuba: o respectivo Município e o de Ubatuba; 
Catanduva: o respectivo Município e os de Ariranha, Catiguá, Elisiário, Ibirá, Irapuã, Itajobi, Marapoama, Novais, Palmares Paulista, Paraíso, Pindorama, Santa Adélia, Tabapuã e Urupês; 
Cruzeiro: o respectivo Município e os de Arapeí, Areias, Bananal, Lavrinhas, Queluz, Silveiras e São José do Barreiro; 
Dracena: o respectivo Município e os de Irapuru, Junqueirópolis, Monte Castelo, Nova Guataporanga, Ouro Verde, Panorama, Paulicéia, Santa Mercedes, São João do Pau d’Alho e Tupi Paulista; 
Fernandópolis: o respectivo Município e os de Estrela d'Oeste, General Salgado, Guarani d'Oeste, Indiaporã, Macedônia, Meridiano, Mira Estrela, Nova Castilho, Ouroeste, Pedranópolis, São João das Duas Pontes e São João de Iracema; 
Franca: o respectivo Município e os de Cristais Paulista, Itirapuã, Patrocínio Paulista, Pedregulho, Restinga, Ribeirão Corrente, Rifaina e São José da Bela Vista; 
Garça: o respectivo Município e os de Álvaro de Carvalho, Alvinlândia, Fernão, Gália, Júlio Mesquita e Lupércio; 
Guaratinguetá: o respectivo Município e os de Aparecida, Cunha, Lagoinha, Potim e Roseira; 
Indaiatuba: o respectivo Município; 
Itanhaém: o respectivo Município e os de Itariri, Miracatu, Mongaguá, Pedro de Toledo e Peruíbe; 
Itapetininga: o respectivo Município e os de Alambari, Angatuba, Guareí, Campina do Monte Alegre, Sarapuí e São Miguel Arcanjo; 
Itapeva: o respectivo Município e os de Barão de Antonina, Bonsucesso de Itararé, Buri, Coronel Macedo, Itaberá, Itaporanga, Itararé, Nova Campina, Ribeirão Branco, Riversul, Taguaí, Taquarituba e Taquarivaí; 
Itapira: o respectivo Município e os de Águas de Lindóia, Lindóia e Socorro; 
Itápolis: o respectivo Município e os de Borborema, Ibitinga, Itaju, Novo Horizonte e Tabatinga; 
Itu: o respectivo Município e o de Cabreúva; 
Ituverava: o respectivo Município e os de Aramina, Buritizal, Guará, Igarapava, Jeriquara e Miguelópis; 
Jaboticabal: o respectivo Município e os de Cândido Rodrigues, Fernando Prestes, Guariba, Monte Alto, Pradópolis, Taiaçu, Taiúva, Taquaritinga e Vista Alegre do Alto; 
Jacareí: o respectivo Município e os de Igaratá e Santa Branca; 
Jales: o respectivo Município e os de Aparecida d'Oeste, Aspásia, Auriflama, Dirce Reis, Dolcinópolis, Guzolândia, Marinópolis, Mesópolis, Nova Canaã Paulista, Palmeira d'Oeste, Paranapuã, Populina, Pontalinda, Rubinéia, Santa Albertina, Santa Clara d'Oeste, Santa Fé do Sul, Santa Rita d'Oeste, Santa Salete, Santana da Ponte Pensa, São Francisco, Suzanópolis, Três Fronteiras, Turmalina, Urânia e Vitória Brasil; 
Jaú: o respectivo Município e os de Bariri, Barra Bonita, Bocaina, Boracéia, Brotas, Dois Córregos, Igaraçu do Tietê, Itapuí, Mineiros do Tietê, Pederneiras e Torrinha; 
José Bonifácio: o respectivo Município e os de Adolfo, Mendonça, Nipoã, Nova Aliança, Planalto, Sales, Ubarana, União Paulista e Zacarias; 
Jundiaí: o respectivo Município e os de Itatiba, Itupeva, Louveira e Vinhedo; 
Lençóis Paulista: o respectivo Município e os de Areiópolis, Borebi e Macatuba; 
Limeira: o respectivo Município e os de Cordeirópolis e Iracemápolis; 
Lins: o respectivo Município e os de Balbinos, Cafelândia, Getulina, Guaiçara, Guarantã, Pirajuí, Pongaí, Promissão, Reginópolis, Sabino e Uru; 
Lorena: o respectivo Município e os de Canas, Cachoeira Paulista e Piquete; 
Marília: o respectivo Município e os de Guaimbé, Lutécia, Ocauçu, Oriente, Oscar Bressane, Pompéia e Vera Cruz; 
Matão: o respectivo Município e os de Dobrada, Nova Europa e Santa Ernestina; 
Moji Guaçu: o respectivo Município e o de Estiva Gerbi; 
Moji Mirim: o respectivo Município e os de Artur Nogueira, Engenheiro Coelho, Holambra e Santo Antônio de Posse; 
Olímpia: o respectivo Município e os de Altair, Cajobi, Embaúba, Guaraci, Icém e Severínia; 
Ourinhos: o respectivo Município e os de Bernardino de Campos, Campos Novos Paulista, Canitar, Chavantes, Espírito Santo do Turvo, Fartura, Ibirarema, Ipauçu, Piraju, Ribeirão do Sul, Salto Grande, Santa Cruz do Rio Pardo, Sarutaiá, São Pedro do Turvo, Tejupá e Timburi; 
Paulínia: o respectivo Município e o de Cosmópolis; 
Penápolis: o respectivo Município e os de Alto Alegre, Avanhadava, Barbosa, Braúna, Glicério e Luisiânia; 
Piedade: o respectivo Município e os de Pilar do Sul, Salto de Pirapora e Tapiraí; 
Pindamonhangaba: o respectivo Município e os de Campos do Jordão, Santo Antônio do Pinhal e São Bento do Sapucaí;  LVIX - Piracicaba: o respectivo Município e os de Águas de São Pedro, Charqueada, Saltinho, Santa Maria da Serra e São Pedro; 
Porto Ferreira: o respectivo Município e os de Descalvado, Luis Antônio, Pirassununga, Santa Cruz das Palmeiras, Santa Rita do Passa Quatro e Tambaú; 
Presidente Prudente: o respectivo Município e os de Alfredo Marcondes, Álvares Machado, Anhumas, Caiabu, Emilianópolis, Estrela do Norte, Indiana, Martinópolis, Narandiba, Pirapozinho, Presidente Bernardes, Regente Feijó, Sandovalina, Santo Expedito, Taciba e Tarabaí; 
Presidente Venceslau: o respectivo Município e os de Caiuá, Marabá Paulista, Piquerobi, Presidente Epitácio, Ribeirão dos Índios e Santo Anastácio; 
Rancharia: o respectivo Município e os de Borá, Iepê, João Ramalho, Nantes e Quatá; 
Registro: o respectivo Município e os de Barra do Turvo, Cajati, Cananéia, Eldorado, Iguape, Ilha Comprida, Jacupiranga, Juquiá, Pariquerá-Açu e Sete Barras; 
Ribeirão Preto: o respectivo Município e os de Cravinhos, Guatapará, São Simão e Serrana; 
Rio Claro: o respectivo Município e os de Analândia, Corumbataí, lpeúna, Itirapina e Santa Gertrudes; 
Salto: o respectivo Município; 
Santa Bárbara D'Oeste: o respectivo Município; 
São Carlos: o respectivo Município e os de Dourado, Ibaté e Ribeirão Bonito; 
São João da Boa Vista: o respectivo Município e os de Aguaí, Águas da Prata, Espírito Santo do Pinhal, Santo Antônio do Jardim e Vargem Grande do Sul; 
São Joaquim da Barra: o respectivo Município e os de lpuã e Morro Agudo; 
São José do Rio Pardo: o respectivo Município e os de Caconde, Casa Branca, Divinolândia, Itobi, Mococa, São Sebastião da Grama e Tapiratiba; 
São José do Rio Preto: o respectivo Município e os de Bady Bassitt, Cedral, Guapiaçu, Ipiguá, Jaci, Mirassol, Neves Paulista, Nova Granada, Onda Verde, Orindiúva, Palestina, Paulo de Faria, Potirendaba e Uchôa; 
São José dos Campos: o respectivo Município e os de Monteiro Lobato e Paraibuna; 
São Roque: o respectivo Município e os de Alumínio, Araçariguama e Mairinque; 
São Sebastião: o respectivo Município e o de Ilhabela; 
Sertãozinho: o respectivo Município e os de Barrinha, Dumont e Pontal; 
Sorocaba: o respectivo Município e os de Araçoiaba da Serra e Votorantim; 
Sumaré: o respectivo Município e o de Hortolândia; 
Tanabi: o respectivo Município e os de Bálsamo, Cosmorama, Macaubal, Mirassolândia, Monte Aprazível e Poloni; 
Tatuí: o respectivo Município e os de Capela do Alto, Cesário Lange, Iperó, Porangaba, Torre de Pedra e Quadra; 
Taubaté: o respectivo Município e os de Natividade da Serra, Redenção da Serra, São Luiz do Paraitinga e Tremembé; 
Teodoro Sampaio: o respectivo Município e os de Euclides da Cunha Paulista, Mirante do Paranapanema e Rosana; 
Tietê: o respectivo Município e os de Boituva, Cerquilho, Conchas, Jumirim, Laranjal Paulista, Pereiras e Porto Feliz; 
Tupã: o respectivo Município e os de Arco-Íris, Bastos, Herculândia, lacri, Parapuã, Queirós, Quintana e Rinópolis; 
Votuporanga: o respectivo Município e os de Álvares Florence, Américo de Campos, Cardoso, Floreal, Gastão Vidigal, Magda, Monções, Nhandeara, Nova Luzitânia, Parisi, Pontes Gestal, Riolândia, Sebastianópolis do Sul e Valentim Gentil. 
São criados no Quadro Permanente de Pessoal da Secretaria do Tribunal Regional do Trabalho da 15ª Região trinta e seis Funções Comissionadas de Assessor de Juiz - FC-09, constantes do Anexo I desta Lei. 
São criados no Quadro Permanente de Pessoal da Secretaria do Tribunal Regional do Trabalho da 15ª Região os cargos de provimento efetivo constantes do Anexo II desta Lei. 
O preenchimento dos cargos de provimento efetivo previstos nesta Lei far-se-á de acordo com as normas legais e regulamentares, observadas as disposições dos incisos I e Il do art. 37 da Constituição Federal, com a redação dada pela Emenda Constitucional nº 19, de 1998. 
As Juntas de Conciliação e Julgamento criadas por esta Lei serão instaladas e os respectivos cargos providos, gradativamente, à medida que ocorrer a disponibilidade de recursos financeiros. 
A competência territorial das Juntas de Conciliação e Julgamento atualmente existentes somente será alterada na data de instalação dos novos órgãos jurisdicionais criados por esta Lei. 
No caso de emancipação de distrito, é mantida a jurisdição da mesma Junta de Conciliação e Julgamento sobre a área territorial do novo Município. 
As despesas decorrentes da execução desta Lei correrão à conta de recursos próprios, consignados ao Tribunal Regional do Trabalho da 15ª Região. 
Esta Lei entra em vigor na data de sua publicação. 
